ACU	ACURA
ACUAA	ACURA CL
ACUAB	ACURA NSX
ACUAC	ACURA RL
ACUAD	ACURA SLX
ACUAE	ACURA INTEGRA
ACUAF	ACURA LEGEND 
ACUAG	ACURA TL 
ACUAH	ACURA VIGOR 
ACUAI	ACURA MDX
ACUAJ	ACURA RSX
ACUXX	ACURA unspecified
AUD	AUDI 
AUDAA	AUDI 80
AUDAB	AUDI 90
AUDAC	AUDI 100 
AUDAD	AUDI 200
AUDAE	AUDI 4000
AUDAF	AUDI 5000
AUDAG	AUDI A4
AUDAH	AUDI A6
AUDAI	AUDI A8
AUDAJ	AUDI CABRIOLET
AUDAK	AUDI FOX 
AUDAL	AUDI GT
AUDAM	AUDI QUATTRO
AUDAN	AUDI S4
AUDAO	AUDI S6
AUDAP	AUDI TT
AUDAQ	AUDI S8
AUDXX	AUDI unspecified
BMW	BMW 
BMWAA	BMW 3-SERIES
BMWAB	BMW 5-SERIES
BMWAC	BMW 6-SERIES
BMWAD	BMW 7-SERIES
BMWAE	BMW 8-SERIES
BMWAF	BMW L6
BMWAG	BMW L7
BMWAH	BMW M3
BMWAI	BMW M5
BMWAJ	BMW M6
BMWAK	BMW Z3
BMWAL	BMW Z4
BMWAM	BMW X5
BMWXX	BMW unspecified
BUI	BUICK 
BUIAA	BUICK CENTURY 
BUIAB	BUICK ELECTRA 
BUIAC	BUICK ESTATE
BUIAD	BUICK LESABRE
BUIAE	BUICK PARK AVENUE
BUIAF	BUICK REATTA
BUIAG	BUICK REGAL
BUIAH	BUICK RIVIERA
BUIAI	BUICK ROADMASTER
BUIAJ	BUICK SKYHAWK
BUIAK	BUICK SKYLARK
BUIAL	BUICK SOMERSET
BUIAM	BUICK RENDEZVOUS
BUIXX	BUICK unspecified
CAD	CADILLAC 
CADAA	CADILLAC ALLANTE
CADAB	CADILLAC BROUGHAM
CADAC	CADILLAC CATERA
CADAD	CADILLAC CIMARRON
CADAE	CADILLAC DEVILLE
CADAF	CADILLAC ELDORADO
CADAG	CADILLAC ESCALADE
CADAH	CADILLAC FLEETWOOD
CADAI	CADILLAC SEVILLE
CADAJ	CADILLAC SIXTY SPECIAL
CADAK	CADILLAC XLR
CADAL	CADILLAC CTS
CADXX	CADILLAC unspecified
CHE	CHEVROLET 
CHEAA	CHEVROLET APV
CHEAB	CHEVROLET ASTRO
CHEAC	CHEVROLET BERETTA
CHEAD	CHEVROLET BLAZER
CHEAE	CHEVROLET CAMARO
CHEAF	CHEVROLET CAPRICE
CHEAG	CHEVROLET CAVALIER
CHEAH	CHEVROLET CELEBRITY
CHEAI	CHEVROLET CHEVETTE
CHEAJ	CHEVROLET CITATION
CHEAK	CHEVROLET CORSICA
CHEAL	CHEVROLET CORVETTE
CHEAM	CHEVROLET EL CAMINO
CHEAN	CHEVROLET EXPRESS VAN
CHEAO	CHEVROLET G-SERIES VAN
CHEAP	CHEVROLET IMPALA
CHEAQ	CHEVROLET LUMINA
CHEAR	CHEVROLET LUMINA APV
CHEAS	CHEVROLET MALIBU
CHEAT	CHEVROLET METRO
CHEAU	CHEVROLET MONTE CARLO
CHEAV	CHEVROLET NOVA
CHEAW	CHEVROLET PICKUP
CHEAX	CHEVROLET PRIZM
CHEAY	CHEVROLET S10 BLAZER
CHEAZ	CHEVROLET SILVERADO
CHEBA	CHEVROLET SPECTRUM
CHEBB	CHEVROLET SPRINT
CHEBC	CHEVROLET SPORTVAN
CHEBD	CHEVROLET SUBURBAN
CHEBE	CHEVROLET TAHOE
CHEBF	CHEVROLET TRACKER
CHEBG	CHEVROLET VENTURE
CHEBH	CHEVROLET AVALANCHE
CHEBI	CHEVROLET TRAILBLAZER
CHEBJ	CHEVROLET SSR
CHEBK	CHEVROLET S-10 PICKUP
CHEXX	CHEVROLET unspecified
CHR	CHRYSLER 
CHRAA	CHRYSLER 300M
CHRAB	CHRYSLER CIRRUS
CHRAC	CHRYSLER CONCORDE
CHRAD	CHRYSLER CONQUEST
CHRAE	CHRYSLER EXECUTIVE
CHRAF	CHRYSLER FIFTH AVE
CHRAG	CHRYSLER IMPERIAL
CHRAH	CHRYSLER LASER
CHRAI	CHRYSLER LEBARON
CHRAJ	CHRYSLER LHS
CHRAK	CHRYSLER NEW YORKER
CHRAL	CHRYSLER SEBRING
CHRAM	CHRYSLER TOWN AND COUNTRY
CHRAN	CHRYSLER PT CRUISER
CHRAO	CHRYSLER CROSSFIRE
CHRAP	CHRYSLER PACIFICA
CHRAQ	CHRYSLER VOYAGER
CHRXX	CHRYSLER unspecified
DAW	DAEWOO
DAWAA	DAEWOO LANOS
DAWAB	DAEWOO NUBIRA
DAWAC	DAEWOO LEGANZA
DAWZZ	DAEWOO unspecified
DOD	DODGE 
DODAA	DODGE 600
DODAB	DODGE ARIES 
DODAC	DODGE AVENGER 
DODAD	DODGE CARAVAN 
DODAE	SRT-4
DODAF	DODGE CHARGER 
DODAG	DODGE COLT 
DODAH	DODGE COLT VISTA
DODAI	DODGE CONQUEST
DODAJ	DODGE DAKOTA
DODAK	DODGE DAYTONA 
DODAL	DODGE DIPLOMAT 
DODAM	DODGE DURANGO 
DODAN	DODGE DYNASTY
DODAO	DODGE GRAND CARAVAN
DODAP	DODGE INTREPID 
DODAQ	DODGE LANCER 
DODAR	DODGE MINI RAM VAN
DODAS	DODGE MONACO
DODAT	DODGE NEON 
DODAU	DODGE OMNI 
DODAV	DODGE PICKUP 
DODAW	DODGE RAIDER
DODAX	DODGE RAM PICKUP
DODAY	DODGE RAM VAN
DODAZ	DODGE RAM WAGON
DODBA	DODGE RAMCHARGER
DODBB	DODGE SHADOW
DODBC	DODGE SPIRIT
DODBD	DODGE STEALTH 
DODBE	DODGE STRATUS 
DODBF	DODGE VIPER
DODXX	DODGE unspecified
EAG	EAGLE 
EAGAA	EAGLE MEDALLION
EAGAB	EAGLE PREMIER 
EAGAC	EAGLE SUMMIT 
EAGAD	EAGLE TALON 
EAGAE	EAGLE VISION 
EAGXX	EAGLE unspecified
FOR	FORD 
FORAA	FORD AEROSTAR
FORAB	FORD ASPIRE
FORAC	FORD BRONCO
FORAD	FORD BRONCO II
FORAE	FORD CLUB WAGON
FORAF	FORD CONTOUR
FORAG	FORD COUNTRY SQUIRE
FORAH	FORD CROWN VICTORIA
FORAI	FORD ECONOLINE
FORAJ	FORD ESCORT
FORAK	FORD EXP
FORAL	FORD EXPEDITION
FORAM	FORD EXPLORER
FORAN	FORD FESTIVA
FORAO	FORD F150
FORAP	FORD F250
FORAQ	FORD F350
FORAR	FORD LTD
FORAS	FORD MUSTANG
FORAT	FORD PICKUP
FORAU	FORD PROBE
FORAV	FORD RANGER
FORAW	FORD TAURUS
FORAX	FORD TEMPO
FORAY	FORD THUNDERBIRD
FORAZ	FORD WINDSTAR
FORBA	FORD FOCUS
FORBB	FORD THINK CITY
FORBC	FORD ESCAPE
FORBD	FORD E-SERIES (VAN)
FORXX	FORD unspecified
GEO	GEO
GEOAA	GEO METRO 
GEOAB	GEO PRISM 
GEOAC	GEO SPECTRUM 
GEOAD	GEO STORM 
GEOAE	GEO TRACKER 
GEOXX	GEO unspecified
GMC	GMC 
GMCAA	GMC CABALLERO
GMCAB	GMC ENVOY
GMCAC	GMC JIMMY
GMCAD	GMC PICKUP
GMCAE	GMC RALLY WAGON
GMCAF	GMC S15 JIMMY
GMCAG	GMC SAFARI
GMCAH	GMC SAVANA VAN
GMCAI	GMC SIERRA
GMCAJ	GMC SONOMA
GMCAK	GMC SUBURBAN
GMCAL	GMC VANDURA
GMCAM	GMC YUKON 
GMCXX	GMC unspecified
HON	HONDA 
HONAA	HONDA ACCORD 
HONAB	HONDA CIVIC 
HONAC	HONDA CR-V
HONAD	HONDA DEL SOL 
HONAE	HONDA PASSPORT
HONAF	HONDA PRELUDE 
HONAG	HONDA ODYSSEY
HONAH	HONDA INSIGHT
HONAI	HONDA PILOT
HONAJ	HONDA ELEMENT
HONAK	HONDA CRX
HONXX	HONDA unspecified
HUM	HUMMER
HUMAA	HUMMER H1
HUMAB	HUMMER H2
HUMXX	HUMMER unspecified
HYU	HYUNDAI
HYUAA	HYUNDAI ACCENT
HYUAB	HYUNDAI ELANTRA
HYUAC	HYUNDAI EXCEL 
HYUAD	HYUNDAI SCOUPE
HYUAE	HYUNDAI SONATA
HYUAF	HYUNDAI TIBURON
HYUAG	HYUNDAI SANTA FE
HYUAH	HYUNDAI XG300
HYUXX	HYUNDAI unspecified
INF	INFINITI
INFAA	INFINITI G20 
INFAB	INFINITI I30 
INFAC	INFINITI J30
INFAD	INFINITI M30
INFAE	INFINITI Q45 
INFAF	INFINITI QX4
INFAG	INFINITI M45
INFAH	INFINITI G35
INFAI	INFINITI FX45
INFAJ	INFINITI I35
INFXX	INFINITI unspecified
ISU	ISUZU 
ISUAA	ISUZU AMIGO
ISUAB	ISUZU HOMBRE
ISUAC	ISUZU I MARK 
ISUAD	ISUZU IMPULSE 
ISUAE	ISUZU OASIS
ISUAF	ISUZU PICKUP
ISUAG	ISUZU RODEO 
ISUAH	ISUZU STYLUS
ISUAI	ISUZU TROOPER
ISUAJ	ISUZU TROOPER II
ISUAK	ISUZU VEHICROSS
ISUAL	ISUZU ASCENDER
ISUXX	ISUZU unspecified
JAG	JAGUAR 
JAGAA	JAGUAR S-TYPE
JAGAB	JAGUAR XJ SERIES
JAGAC	JAGUAR XK8
JAGAD	JAGUAR X-TYPE
JAGXX	JAGUAR unspecified
JEE	JEEP 
JEEAA	JEEP CJ SERIES
JEEAB	JEEP CHEROKEE
JEEAC	JEEP COMANCHE
JEEAD	JEEP GRAND CHEROKEE
JEEAE	JEEP GRAND WAGONEER
JEEAF	JEEP PICKUP
JEEAG	JEEP WAGONEER
JEEAH	JEEP WRANGLER
JEEAI	JEEP LIBERTY
JEEXX	JEEP unspecified
KIA	KIA 
KIAAA	KIA SEPHIA
KIAAB	KIA SPORTAGE 
KIAAC	KIA SPECTRA
KIAAD	KIA RIO
KIAAE	KIA SORENTO
KIAAF	KIA SEDONA
KIAAG	KIA OPTIMA
KIAXX	KIA unspecified
LAN	LAND ROVER
LANAA	LAND ROVER DEFENDER
LANAB	LAND ROVER DISCOVERY
LANAC	LAND ROVER RANGE ROVER
LANAD	LAND ROVER FREELANDER
LANXX	LAND ROVER unspecified
LEX	LEXUS 
LEXAA	LEXUS ES SERIES
LEXAB	LEXUS GS SERIES
LEXAC	LEXUS LS SERIES
LEXAD	LEXUS LX SERIES
LEXAE	LEXUS RX SERIES
LEXAF	LEXUS SC SERIES
LEXAG	LEXUS IS SERIES
LEXAH	LEXUS GX SERIES
LEXXX	LEXUS unspecified
LIN	LINCOLN 
LINAA	LINCOLN CONTINENTAL 
LINAB	LINCOLN LS
LINAC	LINCOLN MARK VII
LINAD	LINCOLN MARK VIII
LINAE	LINCOLN NAVIGATOR
LINAF	LINCOLN TOWN CAR
LINAG	LINCOLN BLACKWOOD
LINAH	LINCOLN AVIATOR
LINXX	LINCOLN unspecified
MAS	MASERATI
MASAA	MASERATI COUPE GT
MASXX	MASERATI unspecified
MAY	MAYBACH
MAYAA	MAYBACH 62
MAYXX	MAYBACH unspecified
MAZ	MAZDA
MAZAA	MAZDA 323
MAZAB	MAZDA 626
MAZAC	MAZDA 929
MAZAD	MAZDA B-SERIES 
MAZAE	MAZDA GLC
MAZAF	MAZDA MIATA
MAZAG	MAZDA MILLENIA
MAZAH	MAZDA MPV
MAZAI	MAZDA MX-3
MAZAJ	MAZDA MX-6
MAZAK	MAZDA NAVAJO
MAZAL	MAZDA PROTEGE
MAZAM	MAZDA RX-7
MAZAN	MAZDA 6
MAZAO	MAZDA TRIBUTE
MAZXX	MAZDA unspecified
MRB	MERCEDES-BENZ 
MRBAA	MERCEDES-BENZ C CLASS
MRBAB	MERCEDES-BENZ CD-T CLASS
MRBAC	MERCEDES-BENZ CE CLASS
MRBAD	MERCEDES-BENZ CL CLASS
MRBAE	MERCEDES-BENZ CLK CLASS
MRBAF	MERCEDES-BENZ D CLASS
MRBAG	MERCEDES-BENZ D-T CLASS
MRBAH	MERCEDES-BENZ E CLASS
MRBAI	MERCEDES-BENZ M CLASS
MRBAJ	MERCEDES-BENZ S CLASS
MRBAK	MERCEDES-BENZ SD CLASS
MRBAL	MERCEDES-BENZ SDL CLASS
MRBAM	MERCEDES-BENZ SE CLASS
MRBAN	MERCEDES-BENZ SEC CLASS
MRBAO	MERCEDES-BENZ SEL CLASS
MRBAP	MERCEDES-BENZ SL CLASS
MRBAQ	MERCEDES-BENZ SLK CLASS
MRBAR	MERCEDES-BENZ TD CLASS
MRBAS	MERCEDES-BENZ TD-T CLASS
MRBAT	MERCEDES-BENZ TE CLASS
MRBAU	MERCEDES-BENZ G-CLASS
MRBXX	MERCEDES-BENZ unspecified
MEC	MERCURY 
MECAA	MERCURY CAPRI 
MECAB	MERCURY COUGAR 
MECAC	MERCURY GRAND MARQUIS
MECAD	MERCURY LYNX
MECAE	MERCURY MARQUIS
MECAF	MERCURY MOUTAINEER
MECAG	MERCURY MYSTIQUE
MECAH	MERCURY SABLE 
MECAI	MERCURY TOPAZ 
MECAJ	MERCURY TRACER
MECAK	MERCURY VILLAGER
MECAL	MERCURY MARUDER
MECXX	MERCURY unspecified
MEK	MERKUR
MEKAA	MERKUR XR4TI
MEKAB	MERKUR SCORPIO
MEKXX	MERKUR unspecified
MIN	MINI
MINAA	MINI COOPER
MINXX	MINI unspecified
MIT	MITSUBISHI 
MITAA	MITSUBISHI 3000GT 
MITAB	MITSUBISHI CORDIA
MITAC	MITSUBISHI DIAMANTE 
MITAD	MITSUBISHI ECLIPSE 
MITAE	MITSUBISHI EXPO
MITAF	MITSUBISHI GALANT 
MITAG	MITSUBISHI MINIVAN
MITAH	MITSUBISHI MIRAGE 
MITAI	MITSUBISHI MONTERO 
MITAJ	MITSUBISHI MONTERO SPORT
MITAK	MITSUBISHI PICKUP
MITAL	MITSUBISHI PRECIS
MITAM	MITSUBISHI SIGMA
MITAN	MITSUBISHI STARION
MITAO	MITSUBISHI TREDIA
MITAP	MITSUBISHI LANCER
MITAQ	MITSUBISHI OUTLANDER
MITXX	MITSUBISHI unspecified
NIS	NISSAN 
NISAA	NISSAN 200SX 
NISAB	NISSAN 240SX
NISAC	NISSAN 300ZX 
NISAD	NISSAN ALTIMA 
NISAE	NISSAN AXXESS
NISAF	NISSAN FRONTIER
NISAG	NISSAN MAXIMA 
NISAH	NISSAN MINIVAN
NISAI	NISSAN NX
NISAJ	NISSAN PATHFINDER 
NISAK	NISSAN PICKUP
NISAL	NISSAN PULSAR
NISAM	NISSAN QUEST
NISAN	NISSAN SENTRA 
NISAO	NISSAN STANZA
NISAP	NISSAN XTERRA
NISAQ	NISSAN MURANO
NISAR	NISSAN 350Z
NISAS	NISSAN TITAN
NISXX	NISSAN unspecified
OLD	OLDSMOBILE 
OLDAA	OLDSMOBILE 88
OLDAB	OLDSMOBILE 98
OLDAC	OLDSMOBILE ACHIEVA
OLDAD	OLDSMOBILE ALERO
OLDAE	OLDSMOBILE AURORA
OLDAF	OLDSMOBILE BRAVADA
OLDAG	OLDSMOBILE CALAIS
OLDAH	OLDSMOBILE CIERA
OLDAI	OLDSMOBILE CUSTOM CRUISER
OLDAJ	OLDSMOBILE CUTLASS CRUISER
OLDAK	OLDSMOBILE CUTLASS SUPREME
OLDAL	OLDSMOBILE DELTA 88
OLDAM	OLDSMOBILE FIRENZA
OLDAN	OLDSMOBILE INTRIGUE
OLDAO	OLDSMOBILE LSS
OLDAP	OLDSMOBILE REGENCY
OLDAQ	OLDSMOBILE SILHOUETTE
OLDAR	OLDSMOBILE TORONADO
OLDAS	OLDSMOBILE CUTLASS
OLDXX	OLDSMOBILE unspecified
PLY	PLYMOUTH 
PLYAA	PLYMOUTH ACCLAIM
PLYAB	PLYMOUTH BREEZE
PLYAC	PLYMOUTH CARAVELLE
PLYAD	PLYMOUTH COLT 
PLYAE	PLYMOUTH COLT VISTA
PLYAF	PLYMOUTH CONQUEST 
PLYAG	PLYMOUTH GRAND FURY 
PLYAH	PLYMOUTH GRAND VOYAGER
PLYAI	PLYMOUTH HORIZON
PLYAK	PLYMOUTH LASER
PLYAL	PLYMOUTH NEON
PLYAM	PLYMOUTH PROWLER
PLYAN	PLYMOUTH RELIANT
PLYAP	PLYMOUTH SUNDANCE
PLYAQ	PLYMOUTH TURISMO 
PLYAR	PLYMOUTH VOYAGER 
PLYXX	PLYMOUTH unspecified
PON	PONTIAC 
PONAA	PONTIAC 1000
PONAB	PONTIAC 6000 
PONAC	PONTIAC BONNEVILLE 
PONAD	PONTIAC FIERO 
PONAE	PONTIAC FIREBIRD 
PONAF	PONTIAC GRAND AM 
PONAG	PONTIAC GRAND PRIX 
PONAH	PONTIAC LEMANS
PONAI	PONTIAC MONTANA
PONAJ	PONTIAC PARISIANNE 
PONAK	PONTIAC SAFARI
PONAL	PONTIAC SUNBIRD 
PONAM	PONTIAC SURFIRE 
PONAN	PONTIAC TRANS SPORT
PONAO	PONTIAC GTO
PONAP	PONTIAC VIBE
PONAQ	PONTIAC AZTEC
PONXX	PONTIAC unspecified
POR	PORSCHE 
PORAA	PORSCHE 911 
PORAB	PORSCHE 924
PORAC	PORSCHE 928
PORAD	PORSCHE 944 
PORAE	PORSCHE 968
PORAF	PORSCHE BOXSTER
PORAG	PORSCHE CAYENNE
PORXX	PORSCHE unspecified
SAA	SAAB 
SAAAA	SAAB 9-3
SAAAB	SAAB 9-5
SAAAC	SAAB 900 
SAAAD	SAAB 9000
SAAXX	SAAB unspecified
SAT	SATURN 
SATAA	SATURN LS
SATAB	SATURN LW
SATAC	SATURN SC
SATAD	SATURN SL
SATAE	SATURN SW
SATAF	SATURN ION
SATAG	SATURN VUE
SATXX	SATURN unspecified
SUB	SUBARU 
SUBAA	SUBARU BRAT
SUBAB	SUBARU DL 
SUBAC	SUBARU FORESTER
SUBAD	SUBARU GL 
SUBAE	SUBARU GL-10
SUBAF	SUBARU IMPREZA
SUBAG	SUBARU JUSTY
SUBAH	SUBARU LEGACY
SUBAI	SUBARU LOYALE
SUBAJ	SUBARU BAJA
SUBAK	SUBARU STD
SUBAL	SUBARU SVX
SUBAM	SUBARU XT
SUBAN	SUBARU OUTBACK
SUBXX	SUBARU unspecified
SUZ	SUZUKI
SUZAA	SUZUKI ESTEEM
SUZAB	SUZUKI GRAND VITARA
SUZAC	SUZUKI SAMURAI 
SUZAD	SUZUKI SIDEKICK
SUZAE	SUZUKI SWIFT
SUZAF	SUZUKI VITARA
SUZAG	SUZUKI X-90
SUZAH	SUZUKI AERIO
SUZAI	SUZUKI XL-7
SUZXX	SUZUKI unspecified
TOY	TOYOTA 
TOYAA	TOYOTA 4RUNNER
TOYAB	TOYOTA AVALON
TOYAC	TOYOTA CAMRY 
TOYAD	TOYOTA CAMRY SOLARA
TOYAE	TOYOTA CELICA 
TOYAF	TOYOTA COROLLA 
TOYAG	TOYOTA CRESSIDA 
TOYAH	TOYOTA LAND CRUISER
TOYAI	TOYOTO MINIVAN
TOYAJ	TOYOTA MR2 
TOYAK	TOYOTA PASEO 
TOYAL	TOYOTA PICKUP
TOYAM	TOYOTO PREVIA
TOYAN	TOYOTA RAV4
TOYAO	TOYOTA SIENNA
TOYAP	TOYOTA SUPRA
TOYAQ	TOYOTA T100
TOYAR	TOYOTA TACOMA
TOYAS	TOYOTA TERCEL 
TOYAT	TOYOTA TUNDRA
TOYAU	TOYOTA HIGHLANDER
TOYAV	TOYOTA MATRIX
TOYAW	TOYOTA SEQUOIA
TOYAX	TOYOTA PRIUS
TOYAY	TOYOTA ECHO
TOYXX	TOYOTA unspecified
VOK	VOLKSWAGEN 
VOKAA	VOLKSWAGEN CABRIO
VOKAB	VOLKSWAGEN CABRIOLET
VOKAC	VOLKSWAGEN CORRADO
VOKAD	VOLKSWAGEN EUROVAN
VOKAE	VOLKSWAGEN FOX
VOKAF	VOLKSWAGEN GOLF 
VOKAG	VOLKSWAGEN TOUAREG
VOKAH	VOLKSWAGEN GTI 
VOKAI	VOLKSWAGEN JETTA 
VOKAJ	VOLKSWAGEN NEW BEETLE
VOKAK	VOLKSWAGEN PASSAT
VOKAL	VOLKSWAGEN QUANTUM 
VOKAM	VOLKSWAGEN SCIROCCO 
VOKAN	VOLKSWAGEN VANAGEN 
VOKAO	VOLKSWAGEN PHAETON
VOKXX	VOLKSWAGEN unspecified
VOV	VOLVO 
VOVAA	VOLVO 240
VOVAB	VOLVO 740 
VOVAC	VOLVO 760
VOVAD	VOLVO 780
VOVAE	VOLVO 850
VOVAF	VOLVO 940
VOVAG	VOLVO 960
VOVAH	VOLVO C70
VOVAI	VOLVO COUPE
VOVAJ	VOLVO DL
VOVAK	VOLVO GL 
VOVAL	VOLVO S70
VOVAM	VOLVO S90
VOVAN	VOLVO V70
VOVAO	VOLVO V90
VOVAP	VOLVO TURBO
VOVAQ	VOLVO XC90
VOVAR	VOLVO S40
VOVAS	VOLVO S60
VOVAT	VOLVO V40
VOVXX	VOLVO unspecified
XXXXX	Unspecified Make/Model
